The Chosen: The Chosen (Anakin Inspired) Font by Repulse Collectibles.
New Horizon: New Horizon (Rey Inspired) Font by Repulse Collectibles.
The Dark Sword: The Dark Sword (DarkSaber Inspired) Font by Repulse Collectibles.
The Assassin: The Assassin (Maul Inspired) Font by Repulse Collectibles.
The Knight: The Knight (Kylo Inspired) Font by Repulse Collectibles.
Wanderer: Wanderer (Malicos Inspired) Font by Repulse Collectibles.
The Protector: The Protector (Kenobi Inspired) Font by Repulse Collectibles.
The Dark Empress: The Dark Empress (Dark Rey Inspired) Font by Repulse Collectibles.
The Son: The Son (Luke Inspired) Font by Repulse Collectibles.
Mercenary
The Master: The Master (Qui-Gon Jinn Inspired) Font by Repulse Collectibles.
The Dark Lord Order: The Dark Lord Order (Vader, Fallen Order Inspired) Font by Repulse Collectibles.
Magenta: Fallen Apprentice Magenta (Kestis Inspired) Font by Repulse Collectibles.
The Princess: The Princess (Leia Inspired) Font, originally called Royalty by Kyberphonic.
Double Agent: Double Agent (Revan Inspired) Font by Darkwolf Sabers.
Truly Lost: Truly Lost (Dark Kestis Inspired) Font by Repulse Collectibles.
Wraith: Wraith (original) Font by Repulse Collectibles.
The Senate: The Senate (Palpatine Inspired) Font by Repulse Collectibles.
Magnetic
Bounty: Bounty (Ahsoka Inspired) Font by Repulse Collectibles.
The Count: The Count (Dooku Inspired) Font by Repulse Collectibles.
Codex Of Light: Codex Of Light Font (original) by Reavers Arsenal.
Cyber Terror: Cyber Terror Font (original) by Reavers Arsenal.
Dark Ages: Dark Ages Font (original) by Reavers Arsenal.
Hatred: Hatred (Malgus Inspired) Font by Reavers Arsenal.
Idyll: Idyll Font (original) by Reavers Arsenal.
Serenity: Serenity Font (original) by Reavers Arsenal.
The Champion: The Champion (Mace inspired) Font by Reavers Arsenal.
The Dark Lord Revisited: The Dark Lord Revisited (Vader inspired) Font by Reavers Arsenal.
The Learner: The Learner (Ezra Inspired) Font by Reavers Arsenal.
The Second: The Second (Second Sister inspired) by Reavers Arsenal. ###
Teacher: Teacher (Yoda inspired) Font by Reavers Arsenal.
Whispers Of Power: Whispers Of Power Font (original) by Reavers Arsenal.
Moon Field: "TSUKINO (Moon Field)" Â© Cosmic Ape 18 October 2021.